vocabulary : 
1)crumbling means :breaking something into small pieces 
the biscuit is crumbling by the Pavan.
2)sizzling means :hissing and crackling sound . or  something is heated or cooked when we are fry 
example : the butter is sizzling on pan .

3) embark means = begin a journey or project ...
4) she is a epitome of kindness the word epitome means = perfect example of something 
5) hazardous means risky or dangerous in manner   example like hazardous behaviour which means driving a car recklessly this is one kind of example.
6) WEIR means = like barrier 
7) funnel a narrow region where the flowing of something.
8)PILE MEANS = accumulation of something like stones in river .
9)bluffs =steep in the sense . or up.
10)sunken cheeks =  inward or recessed cheeks which means embedded to surface it  was caused by improper health conditions , losing of muscles .
11)tolerant = understanding and accepting something 
12)call off = cancel or move to ;
13)mention = hints at ; 
14)easy to available = touch  to available ;
15) wilderness = the place without humans some thing else like forests and mountains ,deserts ...
16)solitary place = the location  that is quite and free from other persons 
17)rejoice = glad or delight or happy or cheer in sense .
18)patriotism  means = love ,devotion and loyalty 
19)loyalty means = a strong feel of support , or devotion of something or some one or faithfulness 
20)hell means = angry ; 
21)pretending means = acting ;
22)craving = something want to desire or achieve . 
23)advocate = someone who supports , defend in favor of  something or someone . 
24)perceptive means = quickly understanding or notice something in quickly . 
25) hurdle  means = challenge or obstacle . example   ; he faced many hurdles in his carrier although he never gave up . 
26) leverage means = advantage gained from something used effectively . example : he got promotion in job due to leverage of experience .   
27) optimization means =  the best possible solution . usually for ( maximization  and minimization ). 
28) cornerstone means = something to be essential , important etc .....
29)  convention means way of doing something . 
 	example : shake of hands is a  social convention . 
30) cripple means = damage or weaken something seriously in  manner 
 corona virus cripple to  many poor peoples in india . this is originate in china but spreading in india a sad to working that . 
31) emphasizes means giving special importance or attention to something . 
 example : i emphasizes studies more than my love . 
32) humility means the way of being humble  which means modest or respect towards others in telugu vinayam 
English: Despite his success, he shows great humility.
Telugu: తన విజయం ఉన్నా, అతడు చాలా వినయంగా ఉంటాడు.
33) embark : which means beginning or starting to do something . 